R 800 600
NO textures/WALL11.xpm
SO textures/WALL12.xpm
WE textures/WALL13.xpm
EA textures/WALL14.xpm
S  textures/skeleton.xpm
F 0,0,60
C 100,150,200
1111111111
1000002021
100N020001
1000000001
1111111111
