R 1920 1080
NO textures/WALL11.xpm
SO textures/WALL12.xpm
WE textures/WALL13.xpm
EA textures/WALL14.xpm
S  textures/sprite_pillar.xpm
F 0,0,60
C 100,150,200
1111111
1000001
100N001
1000001
1111111
