R 1920 1080
NO textures/WALL11.xpm
SO textures/WALL12.xpm
WE textures/WALL13.xpm
EA textures/WALL14.xpm
S  textures/sprite_pillar.xpm
F 0,0,60
C 100,150,200
11111111111111111111111111111111111111
10000000000000000000000000000000000001
10000000000000000000000000000000000001
10101010101010101010100000000000000001
10000000000000000000000000000000000001
10101010101010101010100000000000000001
10000000000000000000000000000000000001
10101010101010101010100000000000000001
10000000000000000000000000000000000001
10101010101010101010100000000000000001
10000000000000000000000000000000000001
10000000000000000000000000000000000001
10000000000000W00000000000000000000001
10000000000000000000000000000000000001
10000000000000000000000000000000000001
10000000000000000000000000000000000001
10002020202020202020202000000000000001
10000000000000000000000000000000000001
10002020202020202020202000000000000001
10000000000000000000000000000000000001
10002020202020202020202000000000000001
10000000000000000000000000000000000001
10002020202020202020202000000000000001
10000000000000000000000000000000000001
11111111111111111111111111111111111111
