R 980 720
NO textures/WALL11.xpm
SO textures/WALL12.xpm
WE textures/WALL13.xpm
EA textures/WALL14.xpm
S  textures/sprite_guard.xpm
F 0,0,60
C 100,150,200
1111111111111111111111111111111111
1000000000100000100000100000011111
1011111010101110111010101111011111
1000100010101010100010100010011111
1011101110101010101111111010011111
1010001000001000001000000010000001
1010111111111111111011111110111111
1010000000000000000010000010000001
1111101111111011111110111011011111
1000101010001010001000111011000101
1010100010101000101011101000010001
1010111010101101111010101101111101
1010000010101000001000000000010001
1010110110101110111011111111110111
1010100011101010010000100000100001
1010101010001000111110101011111101
100000100010N010000000001000100001
1111111111111111111111111111111111
