11111111
10011
1011
1111
110111
1111111
